  #####
  #   #
### $ #
#    ##
#..+*# 
# $  ##
### $ #
  #   #
  #####
Title: SDL Sokoban
Author: Ericson Norberto
Collection: Introduction
AuthorMail: gammasirius@gmail.com
AuthorPage: http://www.gmail.com
Level: 1
Date: 2012-7-21
Comment: SDL Sokoban Introduction