 ############
##.##       #
#...  $ $ $ #
##.#####.####
 #$ $ $ @#
 #       #
 #########
Author: Ghislain MARTIN
Title: LE PISTOLET REVOLVER
Collection: MONDE 05
AuthorMail: sokoban@laposte.net
AuthorPage: http://perso.orange.fr/sokoban
Date: 2001-04-12
