###########
#@        #
# .$$$$$. #
# $#.#.#$ #
# $.....$ #
# $#.#.#$ #
# $.....$ #
# $#.#.#$ #
# .$$$$$. #
#         #
###########
Author: Ghislain MARTIN
Title: DIESE
Collection: MONDE 01
AuthorMail: sokoban@laposte.net
AuthorPage: http://perso.orange.fr/sokoban
Date: 2001-03-12
