#####  #####
#   ####   #
#    $@  . #
############
Author: Ghislain MARTIN
Title: TUTORIAL 2
Collection: TUTORIAL
AuthorMail: sokoban@laposte.net
AuthorPage: http://perso.orange.fr/sokoban
Date: 2006-11-06
