               #######
               #     ##
########       #$ $   #
#  ... ######  # $ $  #
#  ###  ... ## #$ $ $ #
#  ...  ###  ### $ $  #
#@ ###  ...     $ $ $ #
#  ...  ###  ### $ $  #
#  ###  ... ## #$ $ $ #
#  ... ######  # $ $  #
########       #$ $  ##
               #    ##
               ######
Author: Ghislain MARTIN
Title: BOMBE ATOMIQUE
Collection: MONDE 06
AuthorMail: sokoban@laposte.net
AuthorPage: http://perso.orange.fr/sokoban
Date: 2001-05-01
