##########
#@       #
# $$$$$$##
# $      #
# $ $$# .#
# $ $  ..#
# $ #  ..#
# $  ....#
# # .....#
##########
Author: Ghislain MARTIN
Title: LA BARRIERE DE CORAIL
Collection: MONDE 04
AuthorMail: sokoban@laposte.net
AuthorPage: http://perso.orange.fr/sokoban
Date: 2001-04-01
