       #######
      ##....##
     ##....## 
    ##....##  
   ##  $ ##   
  ## $  ##    
 ##    ##     
##  $ ##      
#### ####     
# $   $@#     
# $   $ #     
# $$$$$ #     
#       #     
#########     
Title: EN DIAGONALE
Collection: MONDE 03
Date: 2001-03-19
Author: Ghislain MARTIN
AuthorMail: sokoban@laposte.net
AuthorPage: http://perso.orange.fr/sokoban
