###########
#    @    #
# $$$$$$$ #
#         #
#* * * * *#
# * * * * #
#* * * * *#
# * * * * #
#* * * * *#
#         #
# ....... #
#         #
###########
Author: Ghislain MARTIN
Title: IL PLEUT
Collection: MONDE 03
AuthorMail: sokoban@laposte.net
AuthorPage: http://perso.orange.fr/sokoban
Date: 2001-03-19
