     #####
     #   # #####
     # * ###   #
     #    *  * ####
     ## ####     .#
      #*#  # ######
####### #  #*#
# @   $ #### ##
# * # *  *    #
#   #   ### * #
######### #   #
          #####
Author: Ghislain MARTIN
Title: EFFET D'OPTIQUE
Collection: MONDE 07
AuthorMail: sokoban@laposte.net
AuthorPage: http://perso.orange.fr/sokoban
Date: 2001-05-13
