###########
#   #...# #
# $$#.*.@ #
#  $ ...# #
# $$## ## #
#  $ # #  #
# $$ #   ##
#      ###
########
Author: Ghislain MARTIN
Title: NO PASARAN
Collection: MONDE 07
AuthorMail: sokoban@laposte.net
AuthorPage: http://perso.orange.fr/sokoban
Date: 2001-05-13
